IGN,MatchCount,matchesWon,matchesLoss,WinRate,SkillLevel
Axieof,12,6,6,50,3
Calebanana,10,4,6,40,3
Tankbacca,10,2,8,20,3
Kenenth,2,0,2,0,1
Kenshiryu,20,10,10,50,4
Pritheev,50,24,26,48,9
Nuncat,10,5,5,50,4
Shrey,12,6,6,50,5
Simpmaster,69,0,69,0,1
Joe,90,90,0,100,15
